#########
#       #
#       #
#       #
#     # #
#    $#.#
#    @# # 
#       #
#########
;
#########
#.   $  #
#       #
#       #
#    @  #
#       #
#       # 
#       #
#########
;
#########
#.   $  #
#       #
#       #
#       #
#   $@  #
#      .# 
#       #
#########
;


