#########
#       #
#       #
#       #
#.  $   #
#       #
#       # 
#      @#
#########
;