#########
##   ####
##   #  #
###    .#
### ###.#
# $ ###.#
# $$##### 
#@  #####
#########
;
#########
#       #
#     ###
#    $#.#
#    @# # 
#     # #
#       #
#       #
#########
;
#########
#.   $  #
#       #
#       #
#    @  #
#       #
#       # 
#       #
#########
;
#########
#.   $  #
#       #
#       #
#       #
#   $@  #
#      .# 
#       #
#########
;


