#########
##   ####
##   #  #
###    .#
### ###.#
# $ ###.#
# $$##### 
#@  #####
#########
;
#########
##     ##
## $ @ ##
#### # ##
# $    ##
#  #$# ##
#..$ #  # 
#..     #
#########
;
#########
#....####
#.$  ####
## $ ####
##$ #####
#@$ #####
##  ##### 
#########
#########
;