#########
#       #
#  @    #
#   # ###
#   #$ ##
#      ##
#      .# 
#       #
#########
;
#########
##   ####
##@$ #  #
###     #
### ### #
#   ###.#
#   ##### 
#   #####
#########
;
#########
##   ####
##   #  #
###     #
### ### #
#   ###.#
#  $##### 
#  @#####
#########
;