#########
#       #
#    .  #
#    $  #
#       #
#   $@  #
#      .# 
#       #
#########
;
#########
#      @#
#       #
#       #
#    $  #
#       #
# .     # 
#       #
#########
;
#########
#      .#
#       #
#       #
#    $  #
#       #
# @     # 
#       #
#########
;
#########
#       #
#       #
#   @   #
#       #
#   $ . #
#       # 
#       #
#########
;
#########
#       #
#       #
#       #
#       #
#.  $   #
#       # 
#   @   #
#########
;
#########
#       #
#       #
#   @   #
#       #
#.  $   #
#       # 
#       #
#########
;
#########
#       #
#       #
#       #
#       #
#@  $  .#
#       # 
#       #
#########
;
#########
#       #
#       #
#       #
#       #
#.  $  @#
#       # 
#       #
#########
;
#########
#       #
#       #
#   .   #
#       #
#   $   #
#       # 
#   @   #
#########
;
#########
#       #
#       #
#   @   #
#       #
#   $   #
#       # 
#   .   #
#########
;
#########
#       #
#       #
#   @   #
#       #
#.  $   #
#       # 
#       #
#########
;