#####
#@$.#
#####
;
_########
_#      #
#   .   #
#   $   #
# .$@$. #
####$   #
___#.   #
___#   ##
___#####_
;
