#########
#       #
#       #
#   @   #
#       #
#  $    #
#       # 
#.      #
#########
;
#########
#       #
#       #
#   @   #
#       #
#   $   #
#       # 
#   .   #
#########
;
#########
#       #
#       #
#   @   #
#       #
#.  $   #
#       # 
#       #
#########
;